------------------------------
|~~~~~                       |
|~~~~~                       |
|~~~~~                       |
|                       ,,,,,|
|                       ,,,,,|
|                       ,,,,,|
|                       ,,,,,|
|                  ,,,,,,,,,,|
|                  ,,,,,,,,,,|
|                  ,,,,,,,,,,|
|                  ,,,,,,,,,,|
|                  ,,,,,,,,,,|
|~~~~~                       |
|~~~~~                       |
|~~~~~                       |
|~~~~~                       |
|~~~~~                       |
|~~~~~                       |
------------------------------